111111111
1C11111C1
10C000C01
111000111
1P00000E1
111111111
