11111111
1C000001
1P0000E1
10000001
10000001
11111111