111111111
1CCCC0111
111110111
111110111
1P11100E1
100000111
111111111