11111111
10100001
10101001
10101C01
10010EP1
11111111
