1111111111111111111111111111111111111111
1P10000000000000000000000000000000000CE1
1011111111110000000000000000000000000001
1000000000010000000000000000000000000001
1111111101110000000000000000000000000001
100000C101010000000000000000000000000001
1011100101010000000000000000000000000001
1000100100010000000000000000000000000001
10101C0101010000000000000000000000000001
1110111101011000000000000000000000000001
11000000010C1000000000000000000000000001
1001111111111111111110000000000000000001
1101000000000000000000000000000000000001
1001011101111111111111100000000000000001
100001C001000000000000000000000000000001
1111111011111000000000000000000000000001
1000000000000000000000000000000000000001
1000000000000000000000000000000000000001
1000000000000000000000000000000000000001
1000000000000000000000000000000000000001
1000000000000000000000000000000000000001
1111111111111111111111111111111111111111