1111111111111111111111111111111111111111
1P1C000000000000000000000000000000000CE1
1011111111110111111111111111111110111111
10000000000101C0000000000000000C101000C1
1111111101110111111111101111111010001101
10C000C101010100CCCCCC101C00000010111101
1011100101010100000000101111111110000001
1000100100010001111111101000000000111111
10101C0101010001C0000010101C00000000C001
1110111101011001111110101011111111111101
11000000010C10000000000010000000C0000001
1001111111111111111111111011111111111111
1101000000000000000000000010000000000001
1001011101111111111111111111111111110111
1C0001C0010000000000010C0000000000000111
1111111011111111111101C00001011111111111
1000000000000000000001111111000000000C11
1111111011111111111111C0C000011111111111
1C1000100000000000000000C011110000000001
101010101111111111111110C000000111111101
100010001C0000000000C00000111111C0000001
1111111111111111111111111111111111111111