1111111111111111111111111111111111111111
1P00000000000000000C0000000000000C0000001
1011111111111111111111111111111111111111
1000000000000000000000000000000000000001
1011111111111111111111111111111011111111
1000000000000000000000000000000000000001
1011111111110111111111111111111111111111
1000000000000000000000000000C00000000001
1011111111111111111111111111111111111111
1000000000000000000000000000000000000001
1011111111110111111111111111111111111111
1000000000000000000000000C00000000000C01
1011111111111111111111111111111111111111
1000000000000000000000000000000000000001
1011111111110111111111111111111111111111
1000000000000C0000000000000000000000C001
1011111111111111111111111111111111111111
1000000000000000000000000000000000000001
1011111111111111111111111111111111111111
10000000000000000000000000000000000000E1
1111111111111111111111111111111111111111
