1111111111111111111111111111111111111111111111111
1000000000000000000000111111110000000000000000001
1000000000000000000011111111111100000000000000001
1000000000000000000111111111111110000000000000001
1000000000000000000001111111111000000000000000001
100000000E000000000001111111111000000000000000001
1000000000000000000001111111111000000000000000001
1000000000000000000001111111111000000000000000001
1000000P00000000000001111111111000000000000000001
1000000000000000000001111111111000000000000000001
100000000C000000000001111111111000000000000000001
1000000000000001111101111111111011111000000000001
1000000000000011111111111111111111111100000000001
1000000000000001111111111111111111111000000000001
1000000000000000000011111000111100000000000000001
1111111111111111111111111111111111111111111111111